w,w,w,w,w,w,w,w,w,w,w,w,w,w,w,w,w,w,w,w,w,w
w,,,,,,,,,,,,,,,,,,,,w,w
w,,,,,,,g,g,g,g,,,,,,g,g,g,,w,w
w,,,,,,g,r,r,r,r,g,,,,,r,r,r,,w,w
w,,g,g,g,,r,r,,,r,r,,,,,r,,r,,w,w
w,,r,r,r,,,,,,,,g,g,,,r,,r,,w,w
w,,,,,,,,,,,,r,r,,,r,g,r,,w,w
w,,,,,,,,,,,,,,,,r,r,r,,w,w
w,,,,,,,,,,,,,b,b,,,,,,w,w
w,,,,b,b,b,,,,,,b,w,w,b,b,,,b,w,w
w,b,b,b,w,w,w,b,b,b,b,b,w,w,w,w,w,b,b,w,w,w
w,w,w,w,w,w,w,w,w,w,w,w,w,w,w,w,w,w,w,w,w,w